/ this contains the bruh layers
/ B is door
/ 0 is blank
/ & is a full basket
0 0 0 0 0 0 0 B 0 0 0 0 0 0 0 0 0 0 0 0 0 0 0 0 0 0 0 0 0 0 0 |
0 0 0 0 0 0 0 B 0 0 0 0 0 0 0 0 0 0 0 0 0 0 0 0 0 0 0 0 0 0 0 |
0 0 & 0 0 0 & B 0 0 0 0 0 0 0 0 0 0 0 0 0 0 0 0 0 0 0 0 0 0 0 |
0 0 & 0 0 0 & B 0 0 0 0 0 0 0 0 0 0 0 0 0 0 0 0 0 0 0 0 0 0 0 |
0 0 & 0 & & & B 0 0 0 0 0 0 0 0 0 0 0 0 0 0 0 0 0 0 0 & 0 0 0 |
0 0 & 0 0 0 & B 0 0 0 0	0 0 0 0 0 0 0 0 0 0 0 0 0 0 0 & 0 0 0 |
0 0 & & & & & B 0 0 0 0	0 0 0 0 0 0 0 0 0 0 0 0 0 0 0 & 0 0 0 |
0 0 0 0 0 0 0 0 0 0 0 0	0 0 0 0 0 0 0 0 0 0 0 0 0 0 0 & 0 0 0 |
0 0 0 0 0 0 0 B 0 0 0 0	0 0 0 0 0 B B B B B B 0 0 0 0 & 0 0 0 |
0 0 0 0 0 0 0 B 0 0 0 0	0 0 0 0 0 0 0 0 0 0 0 0 0 0 0 & 0 0 0 |
0 0 0 0 0 0 0 B 0 0 0 0	0 & 0 0 0 0 0 0 0 0 0 0 0 0 0 & 0 0 0 | 
0 0 0 0 0 0 0 B 0 0 0 0	0 & 0 0 0 0 0 0 0 0 0 0 0 0 0 0 0 0 0 |
0 0 0 0 0 0 0 B 0 0 0 0	& & & & & & & & & 0 0 0 0 0 0 0 0 0 0 |
0 0 0 0 0 0 0 B 0 0 0 0	0 0 0 & 0 0 0 0 0 0 0 0 0 0 0 0 0 0 0 |
0 0 0 0 0 0 0 B 0 0 0 0	0 0 0 & 0 0 0 0 0 0 0 0 0 0 0 0 0 0 0 |
0 0 0 0 0 0 0 B 0 0 0 0	0 0 0 0 0 0 0 0 0 0 0 0 0 0 0 0 0 0 0 |
0 0 0 0 0 0 0 B 0 0 0 0	0 0 0 0 0 0 & 0 0 0 0 0 0 0 0 0 0 0 0 |
