/ this contains the bruh layers
/ 0 is door
/ 0 is blank
/ & is a full basket
/ ? is null
? ? ? ? ? ? ? ? ? ? ? ? ? ? ? ? ? ? ? ? ? ? ? ? ? ? ? ? ? ? ? |
? 0 0 0 0 0 0 0 0 0 0 0 0 0 0 0 0 0 0 0 0 0 0 0 0 0 0 0 0 0 ? |
? 0 0 0 0 0 0 0 0 0 0 0 0 0 0 0 0 0 0 0 0 0 0 0 0 0 0 0 0 0 ? |
? 0 0 0 0 & 0 0 0 0 0 0 0 0 0 0 0 0 0 0 0 0 0 0 0 & 0 0 0 0 ? |
? 0 0 0 0 & 0 0 0 0 0 0 0 0 0 0 0 0 0 0 0 0 0 0 0 & 0 0 0 0 ? |
? 0 0 0 0 & & 0 0 0 0 0	0 0 0 0 0 0 0 0 0 0 0 0 0 & 0 0 0 0 ? |
? 0 0 0 0 0 & 0 0 0 0 0	0 0 0 0 0 0 0 0 0 0 0 0 0 & 0 0 0 0 ? |
? 0 0 0 0 0 & 0 0 0 0 0	0 0 0 0 0 0 0 0 0 0 0 0 0 & 0 0 0 0 ? |
? 0 0 0 0 0 & 0 0 0 0 0	0 0 0 0 0 0 0 0 0 0 0 0 0 & 0 0 0 0 ? |
? 0 0 0 0 0 & 0 0 0 0 0	0 0 0 0 0 0 0 0 0 0 0 0 0 & 0 0 0 0 ? |
? 0 0 0 0 0 & 0 0 0 0 0	0 0 0 0 0 0 0 0 0 0 0 0 0 & 0 0 0 0 ? | 
? 0 0 0 0 & & 0 0 0 0 &	& & & & & & & & & & 0 0 0 & 0 0 0 0 ? |
? 0 0 0 0 & 0 0 0 0 0 0	0 0 0 0 0 0 0 0 0 0 0 0 0 & 0 0 0 0 ? |
? 0 0 0 0 0 0 0 0 0 0 0	0 0 0 0 0 0 0 0 0 0 0 0 0 0 0 0 0 0 ? |
? 0 0 0 0 0 0 0 0 0 0 0	0 0 0 0 0 0 0 0 0 0 0 0 0 0 0 0 0 0 ? |
? 0 0 0 0 0 0 0 0 0 0 0	0 0 0 0 0 0 0 0 0 0 0 0 0 0 0 0 0 0 ? |
? ? ? ? ? ? ? ? ? ? ? ? ? ? ? ? ? ? ? ? ? ? ? ? ? ? ? ? ? ? ? |
