/ this is the template for making a map
/ 
? ? ? ? ? ? ? ? ? ? ? ? ? ? ? ? ? ? ? ? ? ? ? ? ? ? ? ? ? ? ? |
? 0 0 0 0 0 0 0 0 0 0 0 0 0 0 0 0 0 0 0 0 0 0 0 0 0 0 0 0 0 ? |
? 0 0 0 0 0 0 0 0 0 0 0 0 0 0 0 0 0 0 0 0 0 0 0 0 0 0 & 0 0 ? |
? 0 0 0 0 & & & & & & & & & & & 0 0 0 0 0 0 0 0 0 0 0 0 0 0 ? |
? 0 0 0 0 & 0 0 0 0 0 0 0 0 0 0 0 0 0 0 0 0 0 0 0 0 0 0 0 0 ? |
? 0 0 0 0 & 0 0 0 0 0 0	0 0 0 0 0 0 0 & 0 0 0 0 0 0 0 0 0 0 ? |
? 0 0 0 0 & 0 0 0 0 0 0	0 0 0 0 0 0 0 & 0 0 0 0 0 0 0 0 0 0 ? |
? 0 0 0 0 & 0 0 0 0 0 0	0 0 0 0 0 0 0 & 0 0 0 0 0 0 0 0 0 0 ? |
? 0 0 0 0 & 0 0 0 0 0 0	0 0 0 0 0 0 0 & 0 0 0 0 0 0 0 0 0 0 ? |
? 0 0 0 0 & 0 0 0 0 0 0	0 0 0 0 0 0 0 & 0 0 0 0 0 0 0 0 0 0 ? |
? 0 0 0 0 & 0 0 0 0 0 0 0 0 0 0 0 0 0 & 0 0 0 0 0 0 0 0 0 0 ? | 
? 0 0 0 0 & 0 0 0 0 0 0 0 0 0 0 0 0 0 & & & & & & & 0 0 0 0 ? |
? 0 0 0 0 0 0 0 0 0 0 0 0 0 0 0 0 0 0 0 0 0 0 0 0 0 0 0 0 0 ? |
? 0 0 0 0 0 0 0 0 0 0 0	0 0 0 0 0 0 0 0 0 0 0 0 0 0 0 0 0 0 ? |
? 0 0 0 0 0 0 0 0 0 0 0	0 0 0 0 0 0 0 0 0 0 0 0 0 0 0 0 & 0 ? |
? 0 0 0 0 0 0 0 0 0 0 0	0 0 0 0 0 0 0 0 0 0 0 0 0 0 0 0 0 0 ? |
? ? ? ? ? ? ? ? ? ? ? ? ? ? ? ? ? ? ? ? ? ? ? ? ? ? ? ? ? ? ? |
